+---+---+---+---+---+---+---+---+---+---+---+---+---+---+---+---+---+---+---+---+
|   |           |   |                       |               |                   |
+   +   +---+   +   +   +   +---+---+---+---+   +---+---+   +   +   +---+---+   +
|       |       |       |               |       |               |   |   |       |
+---+---+   +---+---+---+---+   +---+---+   +---+   +---+---+---+   +   +   +---+
|           |           |   |           |   |       |       |       |           |
+   +---+---+---+   +   +   +---+---+   +   +   +---+   +   +---+---+   +---+---+
|   |               |   |               |   |       |   |       |       |       |
+   +---+---+   +---+   +---+   +---+---+   +---+   +   +---+   +   +---+   +   +
|               |           |           |   |           |       |       |   |   |
+---+---+---+---+---+   +---+   +---+---+   +   +---+---+   +---+   +   +   +   +
|           |                   |           |   |           |       |       |   |
+   +---+   +   +   +---+---+---+   +---+---+---+   +---+---+---+---+---+---+---+
|       |   |   |   |           |   |       |       |               |           |
+---+---+   +---+   +   +---+   +---+   +   +   +---+---+   +---+   +   +---+   +
|       |       |   |   |       |       |   |   |       |       |   |       |   |
+   +   +   +   +   +   +   +---+   +---+   +   +   +   +---+   +   +---+   +---+
|   |       |       |   |           |               |           |   |           |
+   +---+---+---+---+   +   +---+---+---+---+---+---+---+---+---+   +---+---+   +
|                       |       |           |       |               |       |   |
+---+---+---+---+---+   +---+   +   +---+   +   +   +   +---+---+   +   +   +   +
|   |               |   |   |       |       |   |       |       |   |   |       |
+   +   +---+---+   +   +   +---+---+   +---+---+---+---+   +   +   +   +---+---+
|       |       |       |   |               |       |       |   |   |           |
+---+---+---+   +---+   +   +---+---+   +   +   +   +---+   +   +---+---+   +---+
|               |   |       |       |   |       |           |                   |
+   +---+---+---+   +---+---+   +   +   +---+---+---+   +---+---+---+---+---+   +
|               |               |   |   |   |       |       |           |       |
+---+   +---+---+---+   +---+---+   +   +   +   +   +---+   +   +---+---+   +---+
|               |       |       |       |       |       |   |   |               |
+   +---+---+   +   +---+   +---+---+---+---+---+---+   +   +   +   +---+---+   +
|           |   |       |                   |           |   |               |   |
+   +---+   +---+---+   +---+---+---+---+   +   +---+---+   +---+---+---+   +   +
|       |           |       |               |               |       |       |   |
+---+   +---+   +   +---+   +   +---+---+---+---+---+   +---+   +   +   +---+---+
|           |   |           |   |                       |       |   |   |       |
+---+---+   +   +---+---+---+   +   +---+   +---+---+---+   +---+   +   +   +   +
|       |   |                   |   |       |   |       |       |   |       |   |
+   +   +---+---+   +---+   +---+   +   +---+   +   +   +---+   +---+---+---+   +
|   |           |   |           |   |   |           |   |                       |
+   +---+---+   +   +   +---+---+   +   +---+---+---+   +---+---+---+---+   +---+
|   |       |   |   |       |       |       |                       |           |
+   +   +   +---+   +---+---+   +---+---+   +   +---+---+   +---+   +   +---+---+
|       |           |           |       |   |   |               |   |       | S |
+---+---+   +---+---+   +---+---+---+   +   +---+   +---+---+   +---+---+   +   +
|       |   |                   |       |                   |   |       |   |   |
+   +---+   +---+---+---+---+   +   +---+---+---+---+---+---+   +   +   +   +   +
|       |           |           |                       |       |   |       |   |
+---+   +---+---+   +   +---+---+   +---+   +---+---+   +   +---+   +---+---+   +
|                   |               |         E |       |       |               |
+---+---+---+---+---+---+---+---+---+---+---+---+---+---+---+---+---+---+---+---+
