+---+---+---+---+---+---+---+---+---+---+---+---+---+---+---+
|   |                       |       |           |           |
+   +   +---+   +---+---+---+   +   +---+   +   +   +   +---+
|       |   |       |           |       |   |       |       |
+---+   +   +---+   +---+   +---+---+   +---+---+---+---+   +
|   |       |   |       |   |       |       |               |
+   +---+   +   +---+   +   +   +   +---+   +---+   +---+---+
|       |   |       |   |   |   |       |       |   |       |
+---+   +   +---+   +   +   +   +---+   +---+   +   +---+   +
|           |       |   |   |       |   |           |       |
+---+---+---+---+   +   +   +---+   +   +---+---+---+   +   +
| S |           |       |           |           |       |   |
+   +   +---+   +---+   +---+---+---+---+---+   +   +---+   +
|   |       |           |                       |       |   |
+   +---+   +---+---+---+   +---+   +---+---+   +---+---+   +
|       |                   |   |   |                   |   |
+---+   +---+---+   +---+---+   +   +---+---+---+---+   +   +
|       |           |       |               |       |       |
+   +---+   +---+   +---+   +---+---+---+   +   +---+---+   +
|           |               | E             |               |
+---+---+---+---+---+---+---+---+---+---+---+---+---+---+---+
